+--+--+--+--+--+
|              |
+    +--+  +   +
|    | S   | S |
+    +   +--+--+
|    |         |
+     +--+-+   +
|          | S |
+--+--+--+--+--+