+--+--+--+--+--+--+--+--+--+--+--+--+--+--+--+--+
|                                               |
+  +--+  +  +--+  +--+  +--+  +  +  +--+  +--+  +
|     |  |     |  |     |     |  |     |     |  |
+  +  +  +  +  +  +  +  +  +  +  +  +  +  +  +  +
|  |  |     |     |  |     |  |  |  |  |  |  |  |
+  +--+--+  +  +--+  +--+  +  +  +  +  +  +--+  +
|           |           |  |     |     |        |
+  +--+--+  +--+  +--+  +  +  +--+  +--+  +--+  +
|  |     |     |  |     |  |  |     |     |     |
+  +  +  +  +  +  +  +  +  +  +  +  +  +  +  +--+
|     |     |  |     |     |  |  |  |  |  |     |
+--+--+--+--+--+--+--+--+--+--+--+--+--+--+--+--+
