+--+--+--+--+-+
|             |
+    +--+  +  +
|    |     |  |
+    +  +--+--+
|    |        |
+    +--+--+  +
|          | g|
+--+--+--+--+-+