+--+--+--+--+--+
|              |
+    +--+  +   +
|    |     |   |
+    +   +--+--+
|    |      F  |
+     +--+-+   +
|          |  |
+--+--+--+--+--+