+--+--+--+--+--+
|              |
+    +--+  +   +
|    |     |   |
+    +   +--+--+
|    |         |
+     +--+-+   +
|          |   |
+--+--+--+--+--+