+--+--+--+--+--+
|              |
+    +--+  +   +
|    | g   | g |
+    +   +--+--+
|    |         |
+     +--+-+   +
|          | g |
+--+--+--+--+--+